######################################
#                                    #
#                                    #
#                                    # 
#                                    #
#                                    #
#                                    # 
#                                    
#                                    #
#                                    #
#                                    #
#                                    #
#                                    #
#                                    #
#                                    #
#                                    #
#                                    #
#                                    #
#                                    #
#                                    #
#                                    #
#                                    #
#                                    #
#                                    #
####################  ################