######################################
#                                    #
#                                    #
#                                    # 
##################################   #                                 #
#                                    #
#                                    # 
#                                    #
#                                    #
#                                    #
####################     #############     #                              #
#                                    #
#                                    #
#                                    #
#                                    #
#                                    #
##############################     ###                                    #
#                                    #
#                                    #
#                                    #
#                                    #
#                                    #
#                                    #
#                                    #
##########################   #########